Car – auto - سيارة 
Ship – brod -سفينة 
Carpet – cilim - سجادة
Boot – cizma - جزمة
Flower – cvijet - زهرة
Student (primary) – djak - طالب
Tree – drvo - شجرة
Mosque – dzamija - مسجد
Nail – ekser - مسمار
Bottle – flasa - قنينة
Pidgeon – golub - حمامة
Helicopter – helikopter - طائرة مروحية
Bread – hljeb - خبز
Injection – injekcija - حقنة
Needle – igla - ابرة
Hedgehog – jez - قنفذ
Apple – jabuka - تفاحة
Bucket – kanta - دلو
Spoon – kasika - ملعقة
Lollypop – lizalo - مصاصة
Swing – ljuljacka - ارجوحة
Scissors – makaze - مقص
Honey – med - عسل
Snout – njuska -خطم
Knife – noz - سكين
Pencil/pen – olovka - قلم
Towel – peskir - منشفة
Fish – riba - سمكة
Toilet seat – solja - مرحاض
Chair – stolica - كرسي
Table – stol - طاولة
Plate – tanjir - صحن
Wheel – tocak - عجلة
Lighter – upaljac - ولاعة
Fire – vatra - نار
Fork – viljuska - شوكة
Frog – zaba - ضفدع
Curtain – zavjesa - ستائر
Bowl – zdjela - زبدية
Star – zvijezda - نجمة
Lightning - munja - صاعقة
Cow - krava - بقرة 
Watermelon - lubenica - بطيخ 
Parrot - papagaj - ببغاء
Garlic - bijeli luk - ثوم 
Onion - luk - بصل
Fox - lisica - ثعلب
Bull - bik - ثور
Snow - snijeg - ثلج
Fly - muha - ذبابة
Wolf - vuk - ذئب
Corn - kukuruz - ذرة
Feather - pero - ريشة
Shrimp - kozica - روبيان
Pomegranate - nar, sipak - رمان 
Envelop - koverta - ظرف
Nail - nokat - ظفر
Back - ledja - ظهر
Crow - vrana - غراب
Washing machine - ves masina - غسالة
Deer - jelen - غزال
Cloud - oblak - غيمة
Branch - grana - غصن
Strawberry - jagoda - فراولة
Butterfly - leptir - فراشة
Dress - haljina - فستان
Elephant - slon - فيل 
mushroom - gljiva - فطر
Lemon - limun - ليمون
Light bulb - sijalica - لمبة
Toungue - jezik - لسان
Crescent - polumjesec - هلال
Gift - poklon - هدية
Phone - telefon - هاتف
Pyramid - piramida - هرم
Dragonfly - vilin konjic - يعسوب
Hand - ruka - يد
Yoyo - jojo - يويو
Pumkin - tikva - يقطين
Larva - crv - يرقة
worm - glista - دودة
sun - sunce -
moon - mjesec -
rain - kisa -
